w	w	w	w	w	w	w	w	w	w	w	w	w	w	w	w	w	w	w	w	w	w	w	w
w	t	t	t	w	w	w	w	w	w	w	w	w	w	w	w	w	w	w	w	w	e	l	w
w	t	w	e	w	w	w	w	w	w	w	w	w	s	w	e	e	w	w	w	w	e	w	w
w	t	e	e	e	e	e	w	w	w	w	w	e	e	e	e	e	w	w	e	e	e	w	w
w	w	w	e	w	w	e	w	w	w	w	e	e	e	e	w	w	w	w	e	e	e	w	w
w	w	w	e	w	w	e	w	w	w	e	e	w	w	e	e	w	w	w	w	e	e	w	w
w	w	w	e	e	e	e	e	w	e	e	w	w	e	e	w	w	w	e	e	e	e	e	w
w	w	w	w	w	w	e	e	e	e	w	w	e	e	w	w	w	w	w	e	w	w	e	w
w	w	w	w	w	w	w	e	e	e	e	e	e	w	w	w	e	e	w	e	w	w	e	w
w	w	w	w	w	w	e	e	e	e	w	w	e	w	w	w	e	e	w	e	w	e	e	w
w	w	w	w	w	e	e	w	w	e	e	e	e	e	e	w	w	e	w	e	e	e	w	w
w	w	w	w	e	e	w	w	e	e	e	w	w	e	e	w	w	e	e	e	e	w	w	w
w	w	w	e	e	w	w	e	e	e	e	w	w	e	e	w	w	e	e	e	w	w	w	w
w	w	w	e	e	e	e	e	w	w	e	e	e	e	e	e	e	e	e	w	w	w	w	w
w	w	w	e	e	e	e	w	w	w	e	w	w	w	e	w	e	e	w	w	w	w	w	w
w	w	e	e	w	e	w	w	w	m	e	w	w	e	e	w	e	w	w	w	w	w	w	w
w	w	s	e	w	w	w	w	w	w	w	w	w	e	e	e	e	e	w	w	w	w	w	w
w	w	w	w	w	w	w	w	e	w	e	e	e	e	e	w	e	e	e	e	e	w	w	w
w	w	w	w	w	w	w	w	e	w	e	e	e	e	w	w	w	e	w	w	e	w	w	w
w	w	w	e	e	w	e	e	e	w	e	e	e	e	w	w	w	e	w	w	e	w	w	w
w	w	w	e	e	e	e	w	w	e	e	e	w	e	e	w	e	e	e	e	e	e	e	w
w	w	e	e	e	e	e	w	w	e	e	w	w	e	e	e	e	w	w	w	e	w	p	w
w	l	e	w	w	w	e	e	e	e	w	w	w	w	e	v	w	w	w	w	e	p	p	w
w	w	w	w	w	w	w	w	w	w	w	w	w	w	w	w	w	w	w	w	w	w	w	w
