w	w	w	w	w	w	w	w	w	w	w	w	w	w	w	w	w	w	w	w	w	w	w	w
w	v	w	w	e	e	e	e	e	e	e	e	e	e	e	e	e	e	e	e	w	w	w	w
w	e	e	w	w	e	e	e	e	e	e	e	e	e	e	e	e	e	e	w	w	e	e	w
w	e	e	e	w	w	w	e	w	e	w	w	w	e	e	w	w	w	e	w	e	w	e	w
w	e	w	e	e	e	e	e	w	e	e	e	e	e	e	e	e	e	e	e	e	e	e	w
w	w	w	e	e	e	e	e	e	e	e	w	e	e	e	e	e	e	e	w	e	w	e	w
w	e	e	e	w	w	w	e	w	e	w	w	w	e	e	w	w	w	e	w	e	w	e	w
w	e	w	e	w	e	e	e	e	e	e	w	e	e	e	e	e	e	e	e	e	e	e	w
w	e	w	e	e	e	e	e	e	e	e	e	e	e	e	w	e	e	e	e	e	w	e	w
w	e	e	e	w	w	w	e	w	e	w	w	w	e	e	w	w	w	e	w	e	w	e	w
w	e	w	e	e	e	e	e	e	e	e	e	e	e	e	e	e	e	m	e	e	e	e	w
w	e	w	w	w	w	w	e	e	e	w	w	w	e	e	w	w	w	e	w	w	w	e	w
w	e	e	l	w	e	e	e	e	e	e	e	e	e	e	e	e	w	e	e	e	w	e	w
w	e	w	e	w	w	w	e	e	w	w	e	w	w	e	w	w	w	e	e	w	w	e	w
w	e	e	e	e	e	w	e	e	e	e	e	e	e	e	w	e	e	e	e	e	e	e	w
w	e	w	e	w	w	w	e	e	w	w	w	w	e	e	w	w	w	w	e	w	e	e	w
w	e	e	e	w	e	e	e	e	w	e	e	e	e	e	e	e	w	e	w	e	w	e	w
w	e	w	e	w	w	w	e	e	w	e	e	e	e	e	w	w	w	w	e	w	e	e	w
w	e	e	e	e	e	w	e	e	w	w	e	w	w	e	e	e	e	e	e	e	e	e	w
w	e	w	e	w	w	w	w	e	e	e	e	e	w	e	w	w	w	e	e	w	w	w	w
w	e	e	e	w	e	e	e	w	e	e	e	e	w	e	e	e	w	e	e	w	e	e	w
w	e	w	e	w	w	w	w	e	e	w	w	w	w	e	w	w	w	e	e	e	e	e	w
w	e	e	e	e	w	e	e	e	e	e	e	e	e	e	e	w	e	e	e	w	e	s	w
w	w	w	w	w	w	w	w	w	w	w	w	w	w	w	w	w	w	w	w	w	w	w	w
